30,30
12,10
17,10
10,11
11,11
13,11
14,11
15,11
16,11
18,11
19,11
12,12
17,12
